Disease;;TP;TN;FP;FPCONTEXT;FPREAL;FN;FNTVP;FNMETAMAP;TOTAL;PRECISION;PRECISION_FPREAL;PRECISION_REPCONTEXT;RECALL_METAMAP;RECALL_TVP;RECALL;F1_SCORE
1. Disease: Morvan's syndrome DISNET VALIDATION;;39;27;6;4;2;28;4;24;100; 0.87 ; 0.95 ; 0.91 ; 0.62 ; 0.91 ; 0.58 ; 0.70 
2. Disease: Non-alcoholic fatty liver disease DISNET VALIDATION;;12;33;12;9;3;7;5;2;64; 0.50 ; 0.80 ; 0.57 ; 0.86 ; 0.71 ; 0.63 ; 0.56 
3. Disease: Trichinosis DISNET VALIDATION;;18;19;5;3;2;11;9;2;53; 0.78 ; 0.90 ; 0.86 ; 0.90 ; 0.67 ; 0.62 ; 0.69 
4. Disease: Generalized anxiety disorder DISNET VALIDATION;;22;27;13;7;6;22;9;13;84; 0.63 ; 0.79 ; 0.76 ; 0.63 ; 0.71 ; 0.50 ; 0.56 
5. Disease: Benzodiazepine withdrawal syndrome DISNET VALIDATION;;53;23;0;0;0;28;18;10;104; 1.00 ; 1.00 ; 1.00 ; 0.84 ; 0.75 ; 0.65 ; 0.79 
6. Disease: Orthostatic hypotension DISNET VALIDATION;;15;27;10;7;3;3;0;3;55; 0.60 ; 0.83 ; 0.68 ; 0.83 ; 1.00 ; 0.83 ; 0.70 
7. Disease: Intention tremor DISNET VALIDATION;;12;24;17;13;4;14;5;9;67; 0.41 ; 0.75 ; 0.48 ; 0.57 ; 0.71 ; 0.46 ; 0.44 
8. Disease: Optic neuritis DISNET VALIDATION;;6;36;20;11;9;11;5;6;73; 0.23 ; 0.40 ; 0.35 ; 0.50 ; 0.55 ; 0.35 ; 0.28 
9. Disease: Blastomycosis DISNET VALIDATION;;20;24;7;3;4;20;9;11;71; 0.74 ; 0.83 ; 0.87 ; 0.65 ; 0.69 ; 0.50 ; 0.60 
10. Disease: Kaposi's sarcoma DISNET VALIDATION;;21;27;7;2;5;10;5;5;65; 0.75 ; 0.81 ; 0.91 ; 0.81 ; 0.81 ; 0.68 ; 0.71 
11. Disease: Anthrax DISNET VALIDATION;;17;28;14;4;10;21;11;10;80; 0.55 ; 0.63 ; 0.81 ; 0.63 ; 0.61 ; 0.45 ; 0.49 
12. Disease: Normal pressure hydrocephalus DISNET VALIDATION;;15;36;13;7;6;18;5;13;82; 0.54 ; 0.71 ; 0.68 ; 0.54 ; 0.75 ; 0.45 ; 0.49 
13. Disease: MERRF syndrome DISNET VALIDATION;;7;20;18;15;3;6;6;0;51; 0.28 ; 0.70 ; 0.32 ; 1.00 ; 0.54 ; 0.54 ; 0.37 
14. Disease: Orofacial granulomatosis DISNET VALIDATION;;17;22;9;5;4;11;4;7;59; 0.65 ; 0.81 ; 0.77 ; 0.71 ; 0.81 ; 0.61 ; 0.63 
15. Disease: Reflex syncope DISNET VALIDATION;;14;23;8;5;3;13;2;11;58; 0.64 ; 0.82 ; 0.74 ; 0.56 ; 0.88 ; 0.52 ; 0.57 
16. Disease: Pregnancy DISNET VALIDATION;;27;19;2;0;2;13;12;1;61; 0.93 ; 0.93 ; 1.00 ; 0.96 ; 0.69 ; 0.68 ; 0.78 
17. Disease: Arteriovenous malformation DISNET VALIDATION;;26;23;5;3;2;7;6;1;61; 0.84 ; 0.93 ; 0.90 ; 0.96 ; 0.81 ; 0.79 ; 0.81 
18. Disease: Gastroparesis DISNET VALIDATION;;19;30;8;6;2;7;2;5;64; 0.70 ; 0.90 ; 0.76 ; 0.79 ; 0.90 ; 0.73 ; 0.72 
19. Disease: Pituitary apoplexy DISNET VALIDATION;;26;39;7;6;1;16;8;8;88; 0.79 ; 0.96 ; 0.81 ; 0.76 ; 0.76 ; 0.62 ; 0.69 
20. Disease: Scleroderma DISNET VALIDATION;;31;32;9;3;6;16;7;9;88; 0.78 ; 0.84 ; 0.91 ; 0.78 ; 0.82 ; 0.66 ; 0.71 
21. Disease: Diphtheria DISNET VALIDATION;;19;13;4;2;2;9;4;5;45; 0.83 ; 0.90 ; 0.90 ; 0.79 ; 0.83 ; 0.68 ; 0.75 
22. Disease: Chlamydia infection DISNET VALIDATION;;15;34;11;5;6;19;10;9;79; 0.58 ; 0.71 ; 0.75 ; 0.63 ; 0.60 ; 0.44 ; 0.50 
23. Disease: Tethered spinal cord syndrome DISNET VALIDATION;;18;32;8;4;4;18;7;11;76; 0.69 ; 0.82 ; 0.82 ; 0.62 ; 0.72 ; 0.50 ; 0.58 
24. Disease: Hypocalcaemia DISNET VALIDATION;;11;33;18;15;3;12;8;4;74; 0.38 ; 0.79 ; 0.42 ; 0.73 ; 0.58 ; 0.48 ; 0.42 
25. Disease: Conversion disorder DISNET VALIDATION;;23;21;5;2;3;18;14;4;67; 0.82 ; 0.88 ; 0.92 ; 0.85 ; 0.62 ; 0.56 ; 0.67 
26. Disease: Tropical sprue DISNET VALIDATION;;17;19;7;4;3;13;7;6;56; 0.71 ; 0.85 ; 0.81 ; 0.74 ; 0.71 ; 0.57 ; 0.63 
27. Disease: Upper respiratory tract infection DISNET VALIDATION;;24;11;9;8;1;5;4;1;49; 0.73 ; 0.96 ; 0.75 ; 0.96 ; 0.86 ; 0.83 ; 0.77 
28. Disease: Acute decompensated heart failure DISNET VALIDATION;;17;12;11;9;2;4;0;4;44; 0.61 ; 0.89 ; 0.65 ; 0.81 ; 1.00 ; 0.81 ; 0.69 
29. Disease: Hypervitaminosis A DISNET VALIDATION;;22;17;2;0;2;17;13;4;58; 0.92 ; 0.92 ; 1.00 ; 0.85 ; 0.63 ; 0.56 ; 0.70 
30. Disease: Typhoid fever DISNET VALIDATION;;26;23;6;2;4;21;13;8;76; 0.81 ; 0.87 ; 0.93 ; 0.76 ; 0.67 ; 0.55 ; 0.66 
31. Disease: Coccidioidomycosis DISNET VALIDATION;;23;36;3;2;1;31;19;12;93; 0.88 ; 0.96 ; 0.92 ; 0.66 ; 0.55 ; 0.43 ; 0.58 
32. Disease: Obesity hypoventilation syndrome DISNET VALIDATION;;23;15;2;2;0;24;15;9;64; 0.92 ; 1.00 ; 0.92 ; 0.72 ; 0.61 ; 0.49 ; 0.64 
33. Disease: Ascites DISNET VALIDATION;;12;29;12;12;0;17;9;8;70; 0.50 ; 1.00 ; 0.50 ; 0.60 ; 0.57 ; 0.41 ; 0.45 
34. Disease: Scarlet fever DISNET VALIDATION;;28;35;7;5;2;9;8;1;79; 0.80 ; 0.93 ; 0.85 ; 0.97 ; 0.78 ; 0.76 ; 0.78 
35. Disease: Cholesterol embolism DISNET VALIDATION;;33;27;4;3;1;18;13;5;82; 0.89 ; 0.97 ; 0.92 ; 0.87 ; 0.72 ; 0.65 ; 0.75 
36. Disease: Waterhouse–Friderichsen syndrome DISNET VALIDATION;;18;18;9;7;2;14;8;6;59; 0.67 ; 0.90 ; 0.72 ; 0.75 ; 0.69 ; 0.56 ; 0.61 
37. Disease: Carrion's disease DISNET VALIDATION;;24;15;6;1;5;15;7;8;60; 0.80 ; 0.83 ; 0.96 ; 0.75 ; 0.77 ; 0.62 ; 0.70 
38. Disease: Primary hyperparathyroidism DISNET VALIDATION;;28;25;4;3;1;9;9;0;66; 0.88 ; 0.97 ; 0.90 ; 1.00 ; 0.76 ; 0.76 ; 0.81 
39. Disease: Influenza DISNET VALIDATION;;20;16;5;2;3;8;6;2;49; 0.80 ; 0.87 ; 0.91 ; 0.91 ; 0.77 ; 0.71 ; 0.75 
40. Disease: Herpes labialis DISNET VALIDATION;;27;17;5;1;4;12;9;3;61; 0.84 ; 0.87 ; 0.96 ; 0.90 ; 0.75 ; 0.69 ; 0.76 
41. Disease: Cryoglobulinemia DISNET VALIDATION;;18;29;7;4;3;23;11;12;77; 0.72 ; 0.86 ; 0.82 ; 0.60 ; 0.62 ; 0.44 ; 0.55 
42. Disease: Necatoriasis DISNET VALIDATION;;20;17;3;0;3;3;2;1;43; 0.87 ; 0.87 ; 1.00 ; 0.95 ; 0.91 ; 0.87 ; 0.87 
43. Disease: Snakebite DISNET VALIDATION;;26;9;2;0;2;15;7;8;52; 0.93 ; 0.93 ; 1.00 ; 0.76 ; 0.79 ; 0.63 ; 0.75 
44. Disease: Hypomagnesemia DISNET VALIDATION;;23;29;9;8;1;11;6;5;72; 0.72 ; 0.96 ; 0.74 ; 0.82 ; 0.79 ; 0.68 ; 0.70 
45. Disease: Thyrotoxic periodic paralysis DISNET VALIDATION;;17;22;8;6;2;20;10;10;67; 0.68 ; 0.89 ; 0.74 ; 0.63 ; 0.63 ; 0.46 ; 0.55 
46. Disease: Hemolytic-uremic syndrome DISNET VALIDATION;;24;20;1;0;1;17;9;8;62; 0.96 ; 0.96 ; 1.00 ; 0.75 ; 0.73 ; 0.59 ; 0.73 
47. Disease: Streptococcal pharyngitis DISNET VALIDATION;;12;25;9;7;2;8;3;5;54; 0.57 ; 0.86 ; 0.63 ; 0.71 ; 0.80 ; 0.60 ; 0.59 
48. Disease: Xerostomia DISNET VALIDATION;;29;22;4;3;1;27;23;4;82; 0.88 ; 0.97 ; 0.91 ; 0.88 ; 0.56 ; 0.52 ; 0.65 
49. Disease: Rubella DISNET VALIDATION;;15;30;9;7;2;5;2;3;59; 0.63 ; 0.88 ; 0.68 ; 0.83 ; 0.88 ; 0.75 ; 0.68 
50. Disease: Hypercalcaemia DISNET VALIDATION;;28;39;11;9;2;13;5;8;91; 0.72 ; 0.93 ; 0.76 ; 0.78 ; 0.85 ; 0.68 ; 0.70 
51. Disease: Opioid use disorder DISNET VALIDATION;;27;18;3;2;1;34;8;26;82; 0.90 ; 0.96 ; 0.93 ; 0.51 ; 0.77 ; 0.44 ; 0.59 
52. Disease: Whipple's disease DISNET VALIDATION;;25;28;5;2;3;24;12;12;82; 0.83 ; 0.89 ; 0.93 ; 0.68 ; 0.68 ; 0.51 ; 0.63 
53. Disease: Erythema nodosum DISNET VALIDATION;;16;28;13;7;6;8;5;3;65; 0.55 ; 0.73 ; 0.70 ; 0.84 ; 0.76 ; 0.67 ; 0.60 
54. Disease: Non-small-cell lung carcinoma DISNET VALIDATION;;20;12;3;1;2;11;4;7;46; 0.87 ; 0.91 ; 0.95 ; 0.74 ; 0.83 ; 0.65 ; 0.74 
55. Disease: Food intolerance DISNET VALIDATION;;17;26;10;8;2;10;9;1;63; 0.63 ; 0.89 ; 0.68 ; 0.94 ; 0.65 ; 0.63 ; 0.63 
56. Disease: Campylobacteriosis DISNET VALIDATION;;17;22;7;5;2;13;9;4;59; 0.71 ; 0.89 ; 0.77 ; 0.81 ; 0.65 ; 0.57 ; 0.63 
57. Disease: Helicobacter pylori DISNET VALIDATION;;19;19;6;3;3;23;13;10;67; 0.76 ; 0.86 ; 0.86 ; 0.66 ; 0.59 ; 0.45 ; 0.57 
58. Disease: Tonsillitis DISNET VALIDATION;;20;28;5;3;2;17;8;9;70; 0.80 ; 0.91 ; 0.87 ; 0.69 ; 0.71 ; 0.54 ; 0.65 
59. Disease: Intraparenchymal hemorrhage DISNET VALIDATION;;20;38;7;6;1;11;6;5;76; 0.74 ; 0.95 ; 0.77 ; 0.80 ; 0.77 ; 0.65 ; 0.69 
60. Disease: Acute intermittent porphyria DISNET VALIDATION;;37;11;1;1;0;3;3;0;52; 0.97 ; 1.00 ; 0.97 ; 1.00 ; 0.93 ; 0.93 ; 0.95 
61. Disease: Hypovolemia DISNET VALIDATION;;16;13;11;5;6;14;4;10;54; 0.59 ; 0.73 ; 0.76 ; 0.62 ; 0.80 ; 0.53 ; 0.56 
62. Disease: Taeniasis DISNET VALIDATION;;21;17;4;2;2;20;5;15;62; 0.84 ; 0.91 ; 0.91 ; 0.58 ; 0.81 ; 0.51 ; 0.64 
63. Disease: Paratyphoid fever DISNET VALIDATION;;24;15;2;1;1;8;5;3;49; 0.92 ; 0.96 ; 0.96 ; 0.89 ; 0.83 ; 0.75 ; 0.83 
64. Disease: Polyarteritis nodosa DISNET VALIDATION;;21;17;3;1;2;13;6;7;54; 0.88 ; 0.91 ; 0.95 ; 0.75 ; 0.78 ; 0.62 ; 0.72 
65. Disease: Felty's syndrome DISNET VALIDATION;;21;14;5;1;4;13;10;3;53; 0.81 ; 0.84 ; 0.95 ; 0.88 ; 0.68 ; 0.62 ; 0.70 
66. Disease: Thyroid storm DISNET VALIDATION;;20;16;14;13;1;19;12;7;69; 0.59 ; 0.95 ; 0.61 ; 0.74 ; 0.63 ; 0.51 ; 0.55 
67. Disease: Premenstrual syndrome DISNET VALIDATION;;18;29;9;6;3;9;4;5;65; 0.67 ; 0.86 ; 0.75 ; 0.78 ; 0.82 ; 0.67 ; 0.67 
68. Disease: Panic attack DISNET VALIDATION;;23;42;15;12;3;17;7;10;97; 0.61 ; 0.88 ; 0.66 ; 0.70 ; 0.77 ; 0.58 ; 0.59 
69. Disease: Soy allergy DISNET VALIDATION;;24;18;1;1;0;10;4;6;53; 0.96 ; 1.00 ; 0.96 ; 0.80 ; 0.86 ; 0.71 ; 0.81 
70. Disease: Subdural hematoma DISNET VALIDATION;;23;22;3;2;1;15;1;14;63; 0.88 ; 0.96 ; 0.92 ; 0.62 ; 0.96 ; 0.61 ; 0.72 
71. Disease: Hyperosmolar hyperglycemic state DISNET VALIDATION;;22;20;9;8;1;11;6;5;62; 0.71 ; 0.96 ; 0.73 ; 0.81 ; 0.79 ; 0.67 ; 0.69 
72. Disease: Juvenile dermatomyositis DISNET VALIDATION;;18;11;7;3;4;6;4;2;42; 0.72 ; 0.82 ; 0.86 ; 0.90 ; 0.82 ; 0.75 ; 0.73 
73. Disease: Laryngitis DISNET VALIDATION;;15;27;12;5;7;17;4;13;71; 0.56 ; 0.68 ; 0.75 ; 0.54 ; 0.79 ; 0.47 ; 0.51 
74. Disease: Lateral medullary syndrome DISNET VALIDATION;;18;15;7;6;1;14;4;10;54; 0.72 ; 0.95 ; 0.75 ; 0.64 ; 0.82 ; 0.56 ; 0.63 
75. Disease: GM1 gangliosidoses DISNET VALIDATION;;23;17;1;1;0;38;21;17;79; 0.96 ; 1.00 ; 0.96 ; 0.58 ; 0.52 ; 0.38 ; 0.54 
76. Disease: Myocarditis DISNET VALIDATION;;21;24;9;4;5;13;11;2;67; 0.70 ; 0.81 ; 0.84 ; 0.91 ; 0.66 ; 0.62 ; 0.66 
77. Disease: Primary sclerosing cholangitis DISNET VALIDATION;;15;34;7;5;2;13;8;5;69; 0.68 ; 0.88 ; 0.75 ; 0.75 ; 0.65 ; 0.54 ; 0.60 
78. Disease: Prediabetes DISNET VALIDATION;;9;21;12;12;0;10;5;5;52; 0.43 ; 1.00 ; 0.43 ; 0.64 ; 0.64 ; 0.47 ; 0.45 
79. Disease: Ethylene glycol poisoning DISNET VALIDATION;;22;20;1;1;0;26;7;19;69; 0.96 ; 1.00 ; 0.96 ; 0.54 ; 0.76 ; 0.46 ; 0.62 
80. Disease: Vascular dementia DISNET VALIDATION;;27;41;12;7;5;30;12;18;110; 0.69 ; 0.84 ; 0.79 ; 0.60 ; 0.69 ; 0.47 ; 0.56 
81. Disease: Metal fume fever DISNET VALIDATION;;23;9;3;1;2;10;9;1;45; 0.88 ; 0.92 ; 0.96 ; 0.96 ; 0.72 ; 0.70 ; 0.78 
82. Disease: Erysipelas DISNET VALIDATION;;17;16;13;8;5;9;3;6;55; 0.57 ; 0.77 ; 0.68 ; 0.74 ; 0.85 ; 0.65 ; 0.61 
83. Disease: Parry–Romberg syndrome DISNET VALIDATION;;16;21;8;3;5;25;13;12;70; 0.67 ; 0.76 ; 0.84 ; 0.57 ; 0.55 ; 0.39 ; 0.49 
84. Disease: Lambert–Eaton myasthenic syndrome DISNET VALIDATION;;17;26;10;6;4;18;3;15;71; 0.63 ; 0.81 ; 0.74 ; 0.53 ; 0.85 ; 0.49 ; 0.55 
85. Disease: Ross River fever DISNET VALIDATION;;22;13;3;1;2;3;3;0;41; 0.88 ; 0.92 ; 0.96 ; 1.00 ; 0.88 ; 0.88 ; 0.88 
86. Disease: Nicotine poisoning DISNET VALIDATION;;29;9;1;1;0;3;3;0;42; 0.97 ; 1.00 ; 0.97 ; 1.00 ; 0.91 ; 0.91 ; 0.94 
87. Disease: Carciac myxoma DISNET VALIDATION;;25;24;6;4;2;14;10;4;69; 0.81 ; 0.93 ; 0.86 ; 0.86 ; 0.71 ; 0.64 ; 0.71 
88. Disease: Superior mesenteric artery syndrome DISNET VALIDATION;;13;31;13;11;2;14;8;6;71; 0.50 ; 0.87 ; 0.54 ; 0.68 ; 0.62 ; 0.48 ; 0.49 
89. Disease: Reactive hypoglycemia DISNET VALIDATION;;22;23;7;7;0;16;7;9;68; 0.76 ; 1.00 ; 0.76 ; 0.71 ; 0.76 ; 0.58 ; 0.66 
90. Disease: Breast cancer DISNET VALIDATION;;19;49;7;3;4;21;11;10;96; 0.73 ; 0.83 ; 0.86 ; 0.66 ; 0.63 ; 0.48 ; 0.58 
91. Disease: Tetanus DISNET VALIDATION;;25;35;5;4;1;11;4;7;76; 0.83 ; 0.96 ; 0.86 ; 0.78 ; 0.86 ; 0.69 ; 0.76 
92. Disease: Autonomic dysreflexia DISNET VALIDATION;;18;23;5;1;4;19;5;14;65; 0.78 ; 0.82 ; 0.95 ; 0.56 ; 0.78 ; 0.49 ; 0.60 
93. Disease: Arterial embolism DISNET VALIDATION;;24;13;1;0;1;11;6;5;49; 0.96 ; 0.96 ; 1.00 ; 0.83 ; 0.80 ; 0.69 ; 0.80 
94. Disease: Cerebral salt-wasting syndrome DISNET VALIDATION;;26;5;1;0;1;6;3;3;38; 0.96 ; 0.96 ; 1.00 ; 0.90 ; 0.90 ; 0.81 ; 0.88 
95. Disease: Cerebrovascular disease DISNET VALIDATION;;17;34;8;7;1;14;8;6;73; 0.68 ; 0.94 ; 0.71 ; 0.74 ; 0.68 ; 0.55 ; 0.61 
96. Disease: Weight loss DISNET VALIDATION;;4;39;23;16;7;1;1;0;67; 0.15 ; 0.36 ; 0.20 ; 1.00 ; 0.80 ; 0.80 ; 0.25 
97. Disease: Porencephaly DISNET VALIDATION;;16;39;13;5;8;10;3;7;78; 0.55 ; 0.67 ; 0.76 ; 0.70 ; 0.84 ; 0.62 ; 0.58 
98. Disease: Pancreatic cancer DISNET VALIDATION;;24;29;9;4;5;17;11;6;79; 0.73 ; 0.83 ; 0.86 ; 0.80 ; 0.69 ; 0.59 ; 0.65 
99. Disease: Inborn error of metabolism DISNET VALIDATION;;41;17;4;0;4;36;16;20;98; 0.91 ; 0.91 ; 1.00 ; 0.67 ; 0.72 ; 0.53 ; 0.67 
100. Disease: Itch DISNET VALIDATION;;1;39;26;20;6;1;0;1;67; 0.04 ; 0.14 ; 0.05 ; 0.50 ; 1.00 ; 0.50 ; 0.07 
;MAX;53;49;26;20;10;38;23;26;110;;;;;;;
;MIN;1;5;0;0;0;1;0;0;38;;;;;;;
;SUM;2075;2386;761;482;279;1446;737;709;6668;;;;;;;
;;;;;;;;;;;;;;;;;
1. Disease: Morvan's syndrome DISNET VALIDATION;;39;27;6;4;2;28;4;24;100;0.866666667;0.951219512;0.906976744;0.619047619;0.906976744;0.582089552;0.696428571
2. Disease: Non-alcoholic fatty liver disease DISNET VALIDATION;;12;33;12;9;3;7;5;2;64;0.5;0.8;0.571428571;0.857142857;0.705882353;0.631578947;0.558139535
3. Disease: Trichinosis DISNET VALIDATION;;18;19;5;3;2;11;9;2;53;0.782608696;0.9;0.857142857;0.9;0.666666667;0.620689655;0.692307692
4. Disease: Generalized anxiety disorder DISNET VALIDATION;;22;27;13;7;6;22;9;13;84;0.628571429;0.785714286;0.75862069;0.628571429;0.709677419;0.5;0.556962025
5. Disease: Benzodiazepine withdrawal syndrome DISNET VALIDATION;;53;23;0;0;0;28;18;10;104;1;1;1;0.841269841;0.746478873;0.654320988;0.791044776
6. Disease: Orthostatic hypotension DISNET VALIDATION;;15;27;10;7;3;3;0;3;55;0.6;0.833333333;0.681818182;0.833333333;1;0.833333333;0.697674419
7. Disease: Intention tremor DISNET VALIDATION;;12;24;17;13;4;14;5;9;67;0.413793103;0.75;0.48;0.571428571;0.705882353;0.461538462;0.436363636
8. Disease: Optic neuritis DISNET VALIDATION;;6;36;20;11;9;11;5;6;73;0.230769231;0.4;0.352941176;0.5;0.545454545;0.352941176;0.279069767
9. Disease: Blastomycosis DISNET VALIDATION;;20;24;7;3;4;20;9;11;71;0.740740741;0.833333333;0.869565217;0.64516129;0.689655172;0.5;0.597014925
10. Disease: Kaposi's sarcoma DISNET VALIDATION;;21;27;7;2;5;10;5;5;65;0.75;0.807692308;0.913043478;0.807692308;0.807692308;0.677419355;0.711864407
11. Disease: Anthrax DISNET VALIDATION;;17;28;14;4;10;21;11;10;80;0.548387097;0.62962963;0.80952381;0.62962963;0.607142857;0.447368421;0.492753623
12. Disease: Normal pressure hydrocephalus DISNET VALIDATION;;15;36;13;7;6;18;5;13;82;0.535714286;0.714285714;0.681818182;0.535714286;0.75;0.454545455;0.491803279
13. Disease: MERRF syndrome DISNET VALIDATION;;7;20;18;15;3;6;6;0;51;0.28;0.7;0.318181818;1;0.538461538;0.538461538;0.368421053
14. Disease: Orofacial granulomatosis DISNET VALIDATION;;17;22;9;5;4;11;4;7;59;0.653846154;0.80952381;0.772727273;0.708333333;0.80952381;0.607142857;0.62962963
15. Disease: Reflex syncope DISNET VALIDATION;;14;23;8;5;3;13;2;11;58;0.636363636;0.823529412;0.736842105;0.56;0.875;0.518518519;0.571428571
16. Disease: Pregnancy DISNET VALIDATION;;27;19;2;0;2;13;12;1;61;0.931034483;0.931034483;1;0.964285714;0.692307692;0.675;0.782608696
17. Disease: Arteriovenous malformation DISNET VALIDATION;;26;23;5;3;2;7;6;1;61;0.838709677;0.928571429;0.896551724;0.962962963;0.8125;0.787878788;0.8125
18. Disease: Gastroparesis DISNET VALIDATION;;19;30;8;6;2;7;2;5;64;0.703703704;0.904761905;0.76;0.791666667;0.904761905;0.730769231;0.716981132
19. Disease: Pituitary apoplexy DISNET VALIDATION;;26;39;7;6;1;16;8;8;88;0.787878788;0.962962963;0.8125;0.764705882;0.764705882;0.619047619;0.693333333
20. Disease: Scleroderma DISNET VALIDATION;;31;32;9;3;6;16;7;9;88;0.775;0.837837838;0.911764706;0.775;0.815789474;0.659574468;0.712643678
21. Disease: Diphtheria DISNET VALIDATION;;19;13;4;2;2;9;4;5;45;0.826086957;0.904761905;0.904761905;0.791666667;0.826086957;0.678571429;0.745098039
22. Disease: Chlamydia infection DISNET VALIDATION;;15;34;11;5;6;19;10;9;79;0.576923077;0.714285714;0.75;0.625;0.6;0.441176471;0.5
23. Disease: Tethered spinal cord syndrome DISNET VALIDATION;;18;32;8;4;4;18;7;11;76;0.692307692;0.818181818;0.818181818;0.620689655;0.72;0.5;0.580645161
24. Disease: Hypocalcaemia DISNET VALIDATION;;11;33;18;15;3;12;8;4;74;0.379310345;0.785714286;0.423076923;0.733333333;0.578947368;0.47826087;0.423076923
25. Disease: Conversion disorder DISNET VALIDATION;;23;21;5;2;3;18;14;4;67;0.821428571;0.884615385;0.92;0.851851852;0.621621622;0.56097561;0.666666667
26. Disease: Tropical sprue DISNET VALIDATION;;17;19;7;4;3;13;7;6;56;0.708333333;0.85;0.80952381;0.739130435;0.708333333;0.566666667;0.62962963
27. Disease: Upper respiratory tract infection DISNET VALIDATION;;24;11;9;8;1;5;4;1;49;0.727272727;0.96;0.75;0.96;0.857142857;0.827586207;0.774193548
28. Disease: Acute decompensated heart failure DISNET VALIDATION;;17;12;11;9;2;4;0;4;44;0.607142857;0.894736842;0.653846154;0.80952381;1;0.80952381;0.693877551
29. Disease: Hypervitaminosis A DISNET VALIDATION;;22;17;2;0;2;17;13;4;58;0.916666667;0.916666667;1;0.846153846;0.628571429;0.564102564;0.698412698
30. Disease: Typhoid fever DISNET VALIDATION;;26;23;6;2;4;21;13;8;76;0.8125;0.866666667;0.928571429;0.764705882;0.666666667;0.553191489;0.658227848
31. Disease: Coccidioidomycosis DISNET VALIDATION;;23;36;3;2;1;31;19;12;93;0.884615385;0.958333333;0.92;0.657142857;0.547619048;0.425925926;0.575
32. Disease: Obesity hypoventilation syndrome DISNET VALIDATION;;23;15;2;2;0;24;15;9;64;0.92;1;0.92;0.71875;0.605263158;0.489361702;0.638888889
33. Disease: Ascites DISNET VALIDATION;;12;29;12;12;0;17;9;8;70;0.5;1;0.5;0.6;0.571428571;0.413793103;0.452830189
34. Disease: Scarlet fever DISNET VALIDATION;;28;35;7;5;2;9;8;1;79;0.8;0.933333333;0.848484848;0.965517241;0.777777778;0.756756757;0.777777778
35. Disease: Cholesterol embolism DISNET VALIDATION;;33;27;4;3;1;18;13;5;82;0.891891892;0.970588235;0.916666667;0.868421053;0.717391304;0.647058824;0.75
36. Disease: Waterhouse–Friderichsen syndrome DISNET VALIDATION;;18;18;9;7;2;14;8;6;59;0.666666667;0.9;0.72;0.75;0.692307692;0.5625;0.610169492
37. Disease: Carrion's disease DISNET VALIDATION;;24;15;6;1;5;15;7;8;60;0.8;0.827586207;0.96;0.75;0.774193548;0.615384615;0.695652174
38. Disease: Primary hyperparathyroidism DISNET VALIDATION;;28;25;4;3;1;9;9;0;66;0.875;0.965517241;0.903225806;1;0.756756757;0.756756757;0.811594203
39. Disease: Influenza DISNET VALIDATION;;20;16;5;2;3;8;6;2;49;0.8;0.869565217;0.909090909;0.909090909;0.769230769;0.714285714;0.754716981
40. Disease: Herpes labialis DISNET VALIDATION;;27;17;5;1;4;12;9;3;61;0.84375;0.870967742;0.964285714;0.9;0.75;0.692307692;0.76056338
41. Disease: Cryoglobulinemia DISNET VALIDATION;;18;29;7;4;3;23;11;12;77;0.72;0.857142857;0.818181818;0.6;0.620689655;0.43902439;0.545454545
42. Disease: Necatoriasis DISNET VALIDATION;;20;17;3;0;3;3;2;1;43;0.869565217;0.869565217;1;0.952380952;0.909090909;0.869565217;0.869565217
43. Disease: Snakebite DISNET VALIDATION;;26;9;2;0;2;15;7;8;52;0.928571429;0.928571429;1;0.764705882;0.787878788;0.634146341;0.753623188
44. Disease: Hypomagnesemia DISNET VALIDATION;;23;29;9;8;1;11;6;5;72;0.71875;0.958333333;0.741935484;0.821428571;0.793103448;0.676470588;0.696969697
45. Disease: Thyrotoxic periodic paralysis DISNET VALIDATION;;17;22;8;6;2;20;10;10;67;0.68;0.894736842;0.739130435;0.62962963;0.62962963;0.459459459;0.548387097
46. Disease: Hemolytic-uremic syndrome DISNET VALIDATION;;24;20;1;0;1;17;9;8;62;0.96;0.96;1;0.75;0.727272727;0.585365854;0.727272727
47. Disease: Streptococcal pharyngitis DISNET VALIDATION;;12;25;9;7;2;8;3;5;54;0.571428571;0.857142857;0.631578947;0.705882353;0.8;0.6;0.585365854
48. Disease: Xerostomia DISNET VALIDATION;;29;22;4;3;1;27;23;4;82;0.878787879;0.966666667;0.90625;0.878787879;0.557692308;0.517857143;0.651685393
49. Disease: Rubella DISNET VALIDATION;;15;30;9;7;2;5;2;3;59;0.625;0.882352941;0.681818182;0.833333333;0.882352941;0.75;0.681818182
50. Disease: Hypercalcaemia DISNET VALIDATION;;28;39;11;9;2;13;5;8;91;0.717948718;0.933333333;0.756756757;0.777777778;0.848484848;0.682926829;0.7
51. Disease: Opioid use disorder DISNET VALIDATION;;27;18;3;2;1;34;8;26;82;0.9;0.964285714;0.931034483;0.509433962;0.771428571;0.442622951;0.593406593
52. Disease: Whipple's disease DISNET VALIDATION;;25;28;5;2;3;24;12;12;82;0.833333333;0.892857143;0.925925926;0.675675676;0.675675676;0.510204082;0.632911392
53. Disease: Erythema nodosum DISNET VALIDATION;;16;28;13;7;6;8;5;3;65;0.551724138;0.727272727;0.695652174;0.842105263;0.761904762;0.666666667;0.603773585
54. Disease: Non-small-cell lung carcinoma DISNET VALIDATION;;20;12;3;1;2;11;4;7;46;0.869565217;0.909090909;0.952380952;0.740740741;0.833333333;0.64516129;0.740740741
55. Disease: Food intolerance DISNET VALIDATION;;17;26;10;8;2;10;9;1;63;0.62962963;0.894736842;0.68;0.944444444;0.653846154;0.62962963;0.62962963
56. Disease: Campylobacteriosis DISNET VALIDATION;;17;22;7;5;2;13;9;4;59;0.708333333;0.894736842;0.772727273;0.80952381;0.653846154;0.566666667;0.62962963
57. Disease: Helicobacter pylori DISNET VALIDATION;;19;19;6;3;3;23;13;10;67;0.76;0.863636364;0.863636364;0.655172414;0.59375;0.452380952;0.567164179
58. Disease: Tonsillitis DISNET VALIDATION;;20;28;5;3;2;17;8;9;70;0.8;0.909090909;0.869565217;0.689655172;0.714285714;0.540540541;0.64516129
59. Disease: Intraparenchymal hemorrhage DISNET VALIDATION;;20;38;7;6;1;11;6;5;76;0.740740741;0.952380952;0.769230769;0.8;0.769230769;0.64516129;0.689655172
60. Disease: Acute intermittent porphyria DISNET VALIDATION;;37;11;1;1;0;3;3;0;52;0.973684211;1;0.973684211;1;0.925;0.925;0.948717949
61. Disease: Hypovolemia DISNET VALIDATION;;16;13;11;5;6;14;4;10;54;0.592592593;0.727272727;0.761904762;0.615384615;0.8;0.533333333;0.561403509
62. Disease: Taeniasis DISNET VALIDATION;;21;17;4;2;2;20;5;15;62;0.84;0.913043478;0.913043478;0.583333333;0.807692308;0.512195122;0.636363636
63. Disease: Paratyphoid fever DISNET VALIDATION;;24;15;2;1;1;8;5;3;49;0.923076923;0.96;0.96;0.888888889;0.827586207;0.75;0.827586207
64. Disease: Polyarteritis nodosa DISNET VALIDATION;;21;17;3;1;2;13;6;7;54;0.875;0.913043478;0.954545455;0.75;0.777777778;0.617647059;0.724137931
65. Disease: Felty's syndrome DISNET VALIDATION;;21;14;5;1;4;13;10;3;53;0.807692308;0.84;0.954545455;0.875;0.677419355;0.617647059;0.7
66. Disease: Thyroid storm DISNET VALIDATION;;20;16;14;13;1;19;12;7;69;0.588235294;0.952380952;0.606060606;0.740740741;0.625;0.512820513;0.547945205
67. Disease: Premenstrual syndrome DISNET VALIDATION;;18;29;9;6;3;9;4;5;65;0.666666667;0.857142857;0.75;0.782608696;0.818181818;0.666666667;0.666666667
68. Disease: Panic attack DISNET VALIDATION;;23;42;15;12;3;17;7;10;97;0.605263158;0.884615385;0.657142857;0.696969697;0.766666667;0.575;0.58974359
69. Disease: Soy allergy DISNET VALIDATION;;24;18;1;1;0;10;4;6;53;0.96;1;0.96;0.8;0.857142857;0.705882353;0.813559322
70. Disease: Subdural hematoma DISNET VALIDATION;;23;22;3;2;1;15;1;14;63;0.884615385;0.958333333;0.92;0.621621622;0.958333333;0.605263158;0.71875
71. Disease: Hyperosmolar hyperglycemic state DISNET VALIDATION;;22;20;9;8;1;11;6;5;62;0.709677419;0.956521739;0.733333333;0.814814815;0.785714286;0.666666667;0.6875
72. Disease: Juvenile dermatomyositis DISNET VALIDATION;;18;11;7;3;4;6;4;2;42;0.72;0.818181818;0.857142857;0.9;0.818181818;0.75;0.734693878
73. Disease: Laryngitis DISNET VALIDATION;;15;27;12;5;7;17;4;13;71;0.555555556;0.681818182;0.75;0.535714286;0.789473684;0.46875;0.508474576
74. Disease: Lateral medullary syndrome DISNET VALIDATION;;18;15;7;6;1;14;4;10;54;0.72;0.947368421;0.75;0.642857143;0.818181818;0.5625;0.631578947
75. Disease: GM1 gangliosidoses DISNET VALIDATION;;23;17;1;1;0;38;21;17;79;0.958333333;1;0.958333333;0.575;0.522727273;0.37704918;0.541176471
76. Disease: Myocarditis DISNET VALIDATION;;21;24;9;4;5;13;11;2;67;0.7;0.807692308;0.84;0.913043478;0.65625;0.617647059;0.65625
77. Disease: Primary sclerosing cholangitis DISNET VALIDATION;;15;34;7;5;2;13;8;5;69;0.681818182;0.882352941;0.75;0.75;0.652173913;0.535714286;0.6
78. Disease: Prediabetes DISNET VALIDATION;;9;21;12;12;0;10;5;5;52;0.428571429;1;0.428571429;0.642857143;0.642857143;0.473684211;0.45
79. Disease: Ethylene glycol poisoning DISNET VALIDATION;;22;20;1;1;0;26;7;19;69;0.956521739;1;0.956521739;0.536585366;0.75862069;0.458333333;0.61971831
80. Disease: Vascular dementia DISNET VALIDATION;;27;41;12;7;5;30;12;18;110;0.692307692;0.84375;0.794117647;0.6;0.692307692;0.473684211;0.5625
81. Disease: Metal fume fever DISNET VALIDATION;;23;9;3;1;2;10;9;1;45;0.884615385;0.92;0.958333333;0.958333333;0.71875;0.696969697;0.779661017
82. Disease: Erysipelas DISNET VALIDATION;;17;16;13;8;5;9;3;6;55;0.566666667;0.772727273;0.68;0.739130435;0.85;0.653846154;0.607142857
83. Disease: Parry–Romberg syndrome DISNET VALIDATION;;16;21;8;3;5;25;13;12;70;0.666666667;0.761904762;0.842105263;0.571428571;0.551724138;0.390243902;0.492307692
84. Disease: Lambert–Eaton myasthenic syndrome DISNET VALIDATION;;17;26;10;6;4;18;3;15;71;0.62962963;0.80952381;0.739130435;0.53125;0.85;0.485714286;0.548387097
85. Disease: Ross River fever DISNET VALIDATION;;22;13;3;1;2;3;3;0;41;0.88;0.916666667;0.956521739;1;0.88;0.88;0.88
86. Disease: Nicotine poisoning DISNET VALIDATION;;29;9;1;1;0;3;3;0;42;0.966666667;1;0.966666667;1;0.90625;0.90625;0.935483871
87. Disease: Carciac myxoma DISNET VALIDATION;;25;24;6;4;2;14;10;4;69;0.806451613;0.925925926;0.862068966;0.862068966;0.714285714;0.641025641;0.714285714
88. Disease: Superior mesenteric artery syndrome DISNET VALIDATION;;13;31;13;11;2;14;8;6;71;0.5;0.866666667;0.541666667;0.684210526;0.619047619;0.481481481;0.490566038
89. Disease: Reactive hypoglycemia DISNET VALIDATION;;22;23;7;7;0;16;7;9;68;0.75862069;1;0.75862069;0.709677419;0.75862069;0.578947368;0.656716418
90. Disease: Breast cancer DISNET VALIDATION;;19;49;7;3;4;21;11;10;96;0.730769231;0.826086957;0.863636364;0.655172414;0.633333333;0.475;0.575757576
91. Disease: Tetanus DISNET VALIDATION;;25;35;5;4;1;11;4;7;76;0.833333333;0.961538462;0.862068966;0.78125;0.862068966;0.694444444;0.757575758
92. Disease: Autonomic dysreflexia DISNET VALIDATION;;18;23;5;1;4;19;5;14;65;0.782608696;0.818181818;0.947368421;0.5625;0.782608696;0.486486486;0.6
93. Disease: Arterial embolism DISNET VALIDATION;;24;13;1;0;1;11;6;5;49;0.96;0.96;1;0.827586207;0.8;0.685714286;0.8
94. Disease: Cerebral salt-wasting syndrome DISNET VALIDATION;;26;5;1;0;1;6;3;3;38;0.962962963;0.962962963;1;0.896551724;0.896551724;0.8125;0.881355932
95. Disease: Cerebrovascular disease DISNET VALIDATION;;17;34;8;7;1;14;8;6;73;0.68;0.944444444;0.708333333;0.739130435;0.68;0.548387097;0.607142857
96. Disease: Weight loss DISNET VALIDATION;;4;39;23;16;7;1;1;0;67;0.148148148;0.363636364;0.2;1;0.8;0.8;0.25
97. Disease: Porencephaly DISNET VALIDATION;;16;39;13;5;8;10;3;7;78;0.551724138;0.666666667;0.761904762;0.695652174;0.842105263;0.615384615;0.581818182
98. Disease: Pancreatic cancer DISNET VALIDATION;;24;29;9;4;5;17;11;6;79;0.727272727;0.827586207;0.857142857;0.8;0.685714286;0.585365854;0.648648649
99. Disease: Inborn error of metabolism DISNET VALIDATION;;41;17;4;0;4;36;16;20;98;0.911111111;0.911111111;1;0.672131148;0.719298246;0.532467532;0.672131148
100. Disease: Itch DISNET VALIDATION;;1;39;26;20;6;1;0;1;67;0.037037037;0.142857143;0.047619048;0.5;1;0.5;0.068965517